#######################################
# Syntax Coloring Map For TuyaAI Library
#######################################

#######################################
# Datatypes (KEYWORD1)
#######################################

TuyaAI	KEYWORD1
TuyaAIClass	KEYWORD1
TuyaUIClass	KEYWORD1
TuyaAudioClass	KEYWORD1
TuyaMCPClass	KEYWORD1
TuyaSkillClass	KEYWORD1
AIConfig_t	KEYWORD1
AI_MODE_STATE_E	KEYWORD1
AI_CHAT_MODE_E	KEYWORD1
AI_USER_EVT_TYPE_E	KEYWORD1
AI_AUDIO_ALERT_TYPE_E	KEYWORD1
AIEventCallback_t	KEYWORD1
AIStateCallback_t	KEYWORD1
AIAlertCallback_t	KEYWORD1
AI_UI_DISP_TYPE_E	KEYWORD1
AI_UI_WIFI_STATUS_E	KEYWORD1
UIConfig_t	KEYWORD1
AI_AUDIO_CODEC_E	KEYWORD1
SkillType_t	KEYWORD1
SkillData_t	KEYWORD1
AI_AGENT_EMO_T	KEYWORD1
AI_AUDIO_MUSIC_T	KEYWORD1
AI_AUDIO_MUSIC_SRC_E	KEYWORD1
AI_AUDIO_ALERT_TYPE_E	KEYWORD1
SkillPlayControl_t	KEYWORD1
MCPImageMime_t	KEYWORD1
MCPReturnValue_t	KEYWORD1
MCPPropertyList_t	KEYWORD1
MCPToolCallback_t	KEYWORD1

#######################################
# Methods and Functions (KEYWORD2)
#######################################

begin	KEYWORD2
end	KEYWORD2
isInitialized	KEYWORD2
snedText	KEYWORD2
startVoiceInput	KEYWORD2
stopVoiceInput	KEYWORD2
sendImage	KEYWORD2
sendFile	KEYWORD2
setChatMode	KEYWORD2
getChatMode	KEYWORD2
nextChatMode	KEYWORD2
getState	KEYWORD2
getStateString	KEYWORD2
getModeString	KEYWORD2
loadModeConfig	KEYWORD2
saveModeConfig	KEYWORD2
modeKeyHandle	KEYWORD2
interruptChat	KEYWORD2
switchRole	KEYWORD2
requestCloudAlert	KEYWORD2
setEventCallback	KEYWORD2
setStateCallback	KEYWORD2
setAlertCallback	KEYWORD2
getLanguageCode	KEYWORD2
setVolume	KEYWORD2
getVolume	KEYWORD2
volumeUp	KEYWORD2
volumeDown	KEYWORD2
mute	KEYWORD2
unmute	KEYWORD2
isMuted	KEYWORD2
stop	KEYWORD2
pause	KEYWORD2
resume	KEYWORD2
isPlaying	KEYWORD2
playAlert	KEYWORD2
playUrl	KEYWORD2
playData	KEYWORD2
startRecording	KEYWORD2
stopRecording	KEYWORD2
isRecording	KEYWORD2
getType	KEYWORD2
displayMessage	KEYWORD2
displayText	KEYWORD2
displayEmotion	KEYWORD2
displayNotification	KEYWORD2
displayWifiStatus	KEYWORD2
displayChatMode	KEYWORD2
enableUpdateLVGL	KEYWORD2
disableUpdateLVGL	KEYWORD2
setDisplayCallback	KEYWORD2
getTextFont	KEYWORD2
getIconFont	KEYWORD2
getEmoFont	KEYWORD2
getEmoList	KEYWORD2
getWifiIcon	KEYWORD2
registerTool	KEYWORD2
unregisterTool	KEYWORD2
getPropInt	KEYWORD2
getPropBool	KEYWORD2
getPropString	KEYWORD2
setReturnText	KEYWORD2
setReturnImage	KEYWORD2
addReturnContent	KEYWORD2
addReturnResource	KEYWORD2
parse	KEYWORD2
freeMusic	KEYWORD2
dumpMusic	KEYWORD2
unicodeToUtf8	KEYWORD2
getEmotionName	KEYWORD2
getEmotionEmoji	KEYWORD2
isEmotion	KEYWORD2
isMusic	KEYWORD2
isStory	KEYWORD2
isPlayControl	KEYWORD2

#######################################
# Nested Objects (KEYWORD1)
#######################################

UI	KEYWORD1
Audio	KEYWORD1
MCP	KEYWORD1
Skill	KEYWORD1

#######################################
# Constants (LITERAL1)
#######################################

AI_MODE_STATE_INIT	LITERAL1
AI_MODE_STATE_IDLE	LITERAL1
AI_MODE_STATE_LISTEN	LITERAL1
AI_MODE_STATE_UPLOAD	LITERAL1
AI_MODE_STATE_THINK	LITERAL1
AI_MODE_STATE_SPEAK	LITERAL1
AI_CHAT_MODE_HOLD	LITERAL1
AI_CHAT_MODE_ONE_SHOT	LITERAL1
AI_CHAT_MODE_WAKEUP	LITERAL1
AI_CHAT_MODE_FREE	LITERAL1
AI_AUDIO_ALERT_POWER_ON	LITERAL1
AI_AUDIO_ALERT_NOT_ACTIVE	LITERAL1
AI_AUDIO_ALERT_NETWORK_CFG	LITERAL1
AI_AUDIO_ALERT_NETWORK_CONNECTED	LITERAL1
AI_AUDIO_ALERT_NETWORK_FAIL	LITERAL1
AI_AUDIO_ALERT_NETWORK_DISCONNECT	LITERAL1
AI_AUDIO_ALERT_BATTERY_LOW	LITERAL1
AI_AUDIO_ALERT_PLEASE_AGAIN	LITERAL1
AI_AUDIO_ALERT_LONG_KEY_TALK	LITERAL1
AI_AUDIO_ALERT_KEY_TALK	LITERAL1
AI_AUDIO_ALERT_WAKEUP_TALK	LITERAL1
AI_AUDIO_ALERT_RANDOM_TALK	LITERAL1
AI_AUDIO_ALERT_WAKEUP	LITERAL1
BOT_UI_USER	LITERAL1
BOT_UI_WECHAT	LITERAL1
BOT_UI_CHATBOT	LITERAL1
BOT_UI_OLED	LITERAL1
AI_UI_DISP_USER_MSG	LITERAL1
AI_UI_DISP_AI_MSG	LITERAL1
AI_UI_DISP_AI_MSG_STREAM_START	LITERAL1
AI_UI_DISP_AI_MSG_STREAM_DATA	LITERAL1
AI_UI_DISP_AI_MSG_STREAM_END	LITERAL1
AI_UI_DISP_AI_MSG_STREAM_INTERRUPT	LITERAL1
AI_UI_DISP_SYSTEM_MSG	LITERAL1
AI_UI_DISP_EMOTION	LITERAL1
AI_UI_DISP_STATUS	LITERAL1
AI_UI_DISP_NOTIFICATION	LITERAL1
AI_UI_DISP_NETWORK	LITERAL1
AI_UI_DISP_CHAT_MODE	LITERAL1
AI_UI_WIFI_STATUS_DISCONNECTED	LITERAL1
AI_UI_WIFI_STATUS_GOOD	LITERAL1
AI_UI_WIFI_STATUS_FAIR	LITERAL1
AI_UI_WIFI_STATUS_WEAK	LITERAL1
SKILL_TYPE_UNKNOWN	LITERAL1
SKILL_TYPE_EMOTION	LITERAL1
SKILL_TYPE_MUSIC	LITERAL1
SKILL_TYPE_STORY	LITERAL1
SKILL_TYPE_PLAY_CONTROL	LITERAL1
SKILL_TYPE_CLOUD_EVENT	LITERAL1
SKILL_CODE_EMO	LITERAL1
SKILL_CODE_LLM_EMO	LITERAL1
SKILL_CODE_MUSIC	LITERAL1
SKILL_CODE_STORY	LITERAL1
SKILL_CODE_PLAY_CONTROL	LITERAL1
MCP_MIME_JPEG	LITERAL1
MCP_MIME_PNG	LITERAL1
MCP_MIME_GIF	LITERAL1
MCP_MIME_WEBP	LITERAL1
